-1-
9;9;9;9;9;9;9;9;9;9;9;9;9;9;9;9;
9;9;9;9;9;9;9;9;9;9;9;9;9;9;9;9;
9;2;2;2;2;2;2;2;2;2;2;2;2;2;2;9;
9;2;2;2;2;2;2;2;2;2;2;2;2;2;2;9;
9;2;2;2;2;2;2;2;2;2;2;2;2;2;2;9;
9;2;2;2;2;2;2;2;2;2;2;2;2;2;2;9;
9;2;2;2;2;2;2;2;2;2;2;2;2;2;24;9;
9;2;2;2;2;2;2;2;2;2;2;2;2;2;2;9;
9;2;2;2;2;2;2;2;2;2;2;2;2;2;2;9;
9;2;2;2;2;2;2;2;2;2;2;2;2;2;2;9;
9;9;9;9;9;9;9;9;9;9;9;9;9;9;9;9;
9;9;9;9;9;9;9;9;9;9;9;9;9;9;9;9;