-1-
9;9;9;9;9;9;9;9;9;9;9;9;9;9;9;9;
9;9;9;9;9;9;9;9;9;9;9;9;9;9;9;9;
9;2;2;2;2;2;2;2;2;2;2;2;2;2;2;9;
9;2;2;2;2;2;2;2;2;2;2;2;2;2;2;9;
9;2;2;2;2;2;2;2;2;2;2;2;2;2;2;9;
9;2;2;2;2;2;2;2;2;2;2;2;2;2;2;9;
9;24;2;2;2;2;2;2;2;2;2;2;2;2;2;9;
9;2;2;2;2;2;2;2;2;2;2;2;2;2;2;9;
9;2;2;2;2;2;2;2;2;2;2;2;2;2;2;9;
9;2;2;2;2;2;2;2;2;2;2;2;2;2;2;9;
9;9;9;9;9;9;9;9;9;9;9;9;9;9;9;9;
9;9;9;9;9;9;9;9;9;9;9;9;9;9;9;9;