-1-
6;6;6;6;6;6;5;5;5;6;6;6;6;6;6;6;
6;6;6;6;6;6;5;5;5;6;6;6;6;6;6;6;
6;5;5;5;5;5;5;5;5;5;5;5;5;5;5;6;
6;5;5;5;5;5;5;5;5;5;5;5;5;5;5;6;
6;5;5;5;5;5;5;5;5;5;5;5;5;5;5;6;
6;5;5;5;5;5;5;5;5;5;5;5;5;5;5;6;
6;5;5;5;5;5;5;5;5;5;5;5;5;5;5;6;
6;5;5;5;5;5;5;5;5;5;5;5;5;5;5;6;
6;5;5;5;5;5;5;5;5;5;5;5;5;5;5;6;
6;5;5;5;5;5;5;22;5;5;5;5;5;5;5;6;
6;6;6;6;6;6;6;6;6;6;6;6;6;6;6;6;
6;6;6;6;6;6;6;6;6;6;6;6;6;6;6;6;
-2-
6;6;6;6;6;6;5;5;5;6;6;6;6;6;6;6;
6;6;6;6;6;5;5;5;5;5;6;6;6;6;6;6;
6;6;6;6;6;5;5;5;5;5;6;6;6;6;6;6;
6;6;6;6;6;5;5;5;5;5;6;6;6;6;6;6;
6;6;6;6;6;5;5;5;5;5;5;5;5;5;5;6;
6;6;6;6;6;5;5;5;5;5;5;5;5;5;5;5;
6;6;6;6;6;5;5;5;5;5;5;5;5;5;5;5;
6;6;6;6;6;5;5;5;5;5;5;5;5;5;5;5;
6;6;6;6;6;5;5;5;5;5;5;5;5;5;5;6;
6;6;6;6;6;6;6;6;6;6;6;6;6;6;6;6;
6;6;6;6;6;6;6;6;6;6;6;6;6;6;6;6;
6;6;6;6;6;6;6;6;6;6;6;6;6;6;6;6;
-3-
6;6;6;6;6;6;5;5;5;6;6;6;6;6;6;6;
6;6;6;6;6;5;5;5;5;5;6;6;6;6;6;6;
6;6;6;6;6;5;5;5;5;5;6;6;6;6;6;6;
6;6;6;6;6;5;5;5;5;5;6;6;6;6;6;6;
6;5;5;5;5;5;5;5;5;5;6;6;6;6;6;6;
5;5;5;5;5;5;5;5;5;5;6;6;6;6;6;6;
5;5;5;5;5;5;5;5;5;5;6;6;6;6;6;6;
5;5;5;5;5;5;5;5;5;5;6;6;6;6;6;6;
6;5;5;5;5;5;5;5;5;5;6;6;6;6;6;6;
6;6;6;6;6;6;6;6;6;6;6;6;6;6;6;6;
6;6;6;6;6;6;6;6;6;6;6;6;6;6;6;6;
6;6;6;6;6;6;6;6;6;6;6;6;6;6;6;6;
-4-
6;6;6;6;6;6;5;5;5;6;6;6;6;6;6;6;
6;6;6;6;6;5;5;5;5;5;6;6;6;6;6;6;
6;6;6;6;6;5;5;5;5;5;6;6;6;6;6;6;
6;6;6;6;6;5;5;5;5;5;6;6;6;6;6;6;
6;6;6;6;6;5;5;5;5;5;6;6;6;6;6;6;
6;6;6;6;6;5;5;5;5;5;6;6;6;6;6;6;
6;6;6;6;6;5;5;5;5;5;6;6;6;6;6;6;
6;6;6;6;6;5;5;5;5;5;6;6;6;6;6;6;
6;6;6;6;6;5;5;5;5;5;6;6;6;6;6;6;
6;6;6;6;6;5;5;5;5;5;6;6;6;6;6;6;
6;6;6;6;6;5;5;5;5;5;6;6;6;6;6;6;
6;6;6;6;6;6;5;5;5;6;6;6;6;6;6;6;
-5-
6;6;6;6;6;6;5;5;5;6;6;6;6;6;6;6;
6;6;6;6;6;5;5;5;5;5;6;6;6;6;6;6;
6;6;6;6;6;5;5;5;5;5;6;6;6;6;6;6;
6;6;6;6;6;5;5;5;5;5;6;6;6;6;6;6;
6;6;6;6;6;5;5;5;5;5;6;6;6;6;6;6;
6;6;6;6;6;5;5;5;5;5;6;6;6;6;6;6;
6;6;6;6;6;5;5;5;5;5;6;6;6;6;6;6;
6;6;6;6;6;5;5;5;5;5;6;6;6;6;6;6;
6;6;6;6;6;5;5;5;5;5;6;6;6;6;6;6;
6;6;6;6;6;5;5;5;5;5;6;6;6;6;6;6;
6;6;6;6;6;5;5;5;5;5;6;6;6;6;6;6;
6;6;6;6;6;6;5;5;5;6;6;6;6;6;6;6;
-6-
6;6;6;6;6;6;5;5;5;6;6;6;6;6;6;6;
6;6;6;6;6;5;5;5;5;5;6;6;6;6;6;6;
6;6;6;6;6;5;5;5;5;5;6;6;6;6;6;6;
6;6;6;6;6;5;5;5;5;5;6;6;6;6;6;6;
6;6;6;6;6;5;5;5;5;5;6;6;6;6;6;6;
6;6;6;6;6;5;5;5;5;5;6;6;6;6;6;6;
6;6;6;6;6;5;5;5;5;5;6;6;6;6;6;6;
6;6;6;6;6;5;5;5;5;5;6;6;6;6;6;6;
6;6;6;6;6;5;5;5;5;5;6;6;6;6;6;6;
6;6;6;6;6;5;5;5;5;5;6;6;6;6;6;6;
6;6;6;6;6;5;5;5;5;5;6;6;6;6;6;6;
6;6;6;6;6;6;5;5;5;6;6;6;6;6;6;6;
-7-
6;6;6;6;6;6;6;6;6;6;6;6;6;6;6;6;
6;6;6;6;6;6;6;6;6;6;6;6;6;6;6;6;
6;6;6;6;6;6;6;6;6;6;6;6;6;6;6;6;
6;6;6;6;6;6;6;6;6;6;6;6;6;6;6;6;
6;6;6;6;6;5;5;5;5;5;5;5;5;5;5;6;
6;6;6;6;6;5;5;5;5;5;5;5;5;5;5;5;
6;6;6;6;6;5;5;5;5;5;5;5;5;5;5;5;
6;6;6;6;6;5;5;5;5;5;5;5;5;5;5;5;
6;6;6;6;6;5;5;5;5;5;5;5;5;5;5;6;
6;6;6;6;6;5;5;5;5;5;6;6;6;6;6;6;
6;6;6;6;6;5;5;5;5;5;6;6;6;6;6;6;
6;6;6;6;6;6;5;5;5;6;6;6;6;6;6;6;
-8-
6;6;6;6;6;6;6;6;6;6;6;6;6;6;6;6;
6;6;6;6;6;6;6;6;6;6;6;6;6;6;6;6;
6;6;6;6;6;6;6;6;6;6;6;6;6;6;6;6;
6;6;6;6;6;6;6;6;6;6;6;6;6;6;6;6;
6;5;5;5;5;5;5;5;5;5;6;6;6;6;6;6;
5;5;5;5;5;5;5;5;5;5;6;6;6;6;6;6;
5;5;5;5;5;5;5;5;5;5;6;6;6;6;6;6;
5;5;5;5;5;5;5;5;5;5;6;6;6;6;6;6;
6;5;5;5;5;5;5;5;5;5;6;6;6;6;6;6;
6;6;6;6;6;5;5;5;5;5;6;6;6;6;6;6;
6;6;6;6;6;5;5;5;5;5;6;6;6;6;6;6;
6;6;6;6;6;6;5;5;5;6;6;6;6;6;6;6;
-9-
6;6;6;6;6;6;6;6;6;6;6;6;6;6;6;6;
6;5;5;5;5;5;5;5;5;5;5;5;5;5;5;6;
6;5;5;5;5;5;5;5;5;5;5;5;5;5;5;6;
6;5;5;5;5;5;5;5;5;5;5;5;5;5;5;6;
6;5;5;5;5;5;5;5;5;5;5;5;5;5;5;6;
6;5;5;5;5;5;5;5;5;5;5;5;5;5;5;6;
6;5;5;5;5;5;5;5;5;5;5;5;5;5;5;6;
6;5;5;5;5;5;5;5;5;5;5;5;5;5;5;6;
6;5;5;5;5;5;5;5;5;5;5;5;5;5;5;6;
6;5;5;5;5;5;5;5;5;5;5;5;5;5;5;6;
6;5;5;5;5;5;5;5;5;5;5;5;5;5;5;6;
6;6;6;6;6;6;5;5;5;6;6;6;6;6;6;6;